12 9
4 4 4 4 4 4 4 4 4
4 0 0 0 0 0 0 0 4
4 0 0 0 0 0 0 0 4
4 0 0 0 0 0 0 0 4
4 0 0 0 0 0 0 0 4
4 0 0 0 0 0 0 0 4
4 0 0 0 5 0 0 0 4
4 0 0 0 0 0 0 0 4
4 0 0 0 0 0 0 0 4
4 0 0 0 0 0 0 0 4
4 0 0 0 0 0 0 0 4
4 4 4 4 6 4 4 4 4
